tileswide 21
tileshigh 26
tilewidth 32
tileheight 32

layer 0
159,159,159,159,159,159,159,159,159,159,159,159,159,159,159,159,159,159,159,159,159,
159,159,159,159,159,159,159,159,159,159,159,159,159,159,159,159,159,159,159,159,159,
159,159,156,157,157,157,157,157,157,158,159,159,159,159,159,159,159,159,159,159,159,
159,159,169,6,7,7,7,7,8,170,157,157,158,159,159,159,159,159,159,159,159,
159,159,169,22,23,23,23,23,70,7,7,7,8,158,159,159,159,159,159,159,159,
159,159,169,22,23,23,23,23,23,23,23,23,70,8,157,157,157,157,158,159,159,
159,159,169,22,23,23,23,23,54,39,39,39,55,70,7,7,7,8,171,159,159,
159,159,169,22,23,23,23,23,24,186,186,186,22,23,23,23,23,70,8,158,159,
159,159,169,38,39,39,39,39,40,202,202,202,38,39,39,39,55,23,24,171,159,
159,159,185,186,186,186,186,186,187,159,159,159,185,186,186,169,22,23,24,171,159,
159,159,201,202,202,202,202,202,203,159,159,159,201,202,202,169,22,23,24,171,159,
156,157,157,157,157,157,157,157,157,157,157,157,158,159,159,169,22,23,24,171,159,
169,6,7,7,7,7,7,7,7,7,7,8,171,159,159,169,22,23,24,171,159,
169,22,23,23,23,23,23,23,23,23,23,24,171,159,156,170,22,23,24,171,159,
169,22,23,23,23,23,23,23,23,23,23,24,170,157,170,170,22,23,24,171,159,
169,22,23,23,23,23,23,23,23,23,23,70,7,7,7,7,71,54,40,171,159,
169,22,23,23,23,23,23,23,23,23,23,23,23,23,23,23,54,40,186,187,159,
169,22,23,23,23,23,23,23,23,23,23,23,23,23,23,54,186,187,202,203,159,
169,22,23,23,23,23,23,23,23,23,23,54,39,39,39,40,202,203,159,159,159,
169,22,23,23,23,23,23,23,23,23,23,24,186,186,186,187,159,159,159,159,159,
169,22,23,23,23,23,23,23,23,23,54,40,202,202,202,203,159,159,159,159,159,
169,22,23,23,23,23,23,23,23,54,40,171,159,159,159,159,159,159,159,159,159,
169,22,23,23,23,23,23,23,23,24,170,187,159,159,159,159,159,159,159,159,159,
169,38,39,39,39,39,39,39,39,40,171,203,159,159,159,159,159,159,159,159,159,
185,186,186,186,186,186,186,186,186,186,187,159,159,159,159,159,159,159,159,159,159,
201,203,203,203,203,203,203,203,203,203,203,159,159,159,159,159,159,159,159,159,159,

layer 2
0,0,0,0,1,1,1,1,0,0,0,0,0,0,0,0,0,0,0,0,0,
0,1,1,1,0,0,0,1,1,1,1,0,0,0,0,0,0,0,0,0,0,
0,1,0,0,0,0,0,0,0,0,1,1,1,1,0,0,0,0,0,0,0,
0,1,0,0,0,0,0,0,0,0,0,0,0,1,1,0,0,0,0,0,0,
0,1,0,0,0,0,0,0,0,0,0,0,0,0,1,1,1,1,1,1,0,
0,1,0,0,0,0,0,0,0,0,0,0,0,0,0,0,0,0,0,1,0,
0,1,0,0,0,0,0,0,0,0,0,0,0,0,0,0,0,0,0,1,1,
0,1,0,0,0,0,0,0,0,0,0,0,0,0,0,0,0,0,0,0,1,
0,1,0,0,0,0,0,0,0,1,1,1,0,0,0,0,0,0,0,0,1,
0,1,0,0,0,0,0,0,0,1,0,1,0,0,0,0,0,0,0,0,1,
0,1,1,1,1,1,1,1,1,1,0,1,1,1,1,0,0,0,0,0,1,
0,0,0,0,0,0,0,0,0,0,0,0,0,1,1,0,0,0,0,0,1,
0,0,0,0,0,0,0,0,0,0,0,0,0,1,1,0,0,0,0,0,1,
0,0,0,0,0,0,0,0,0,0,0,0,0,1,0,0,0,0,0,0,1,
0,0,0,0,0,0,0,0,0,0,0,0,0,0,0,0,0,0,0,0,1,
0,0,0,0,0,0,0,0,0,0,0,0,0,0,0,0,0,0,0,0,1,
0,0,0,0,0,0,0,0,0,0,0,0,0,0,0,0,0,0,0,0,1,
0,0,0,0,0,0,0,0,0,0,0,0,0,0,0,0,0,0,1,1,1,
0,0,0,0,0,0,0,0,0,0,0,0,0,0,0,0,1,1,1,0,0,
0,0,0,0,0,0,0,0,0,0,0,0,0,0,0,0,1,0,0,0,0,
0,0,0,0,0,0,0,0,0,0,0,0,1,1,1,1,1,0,0,0,0,
0,0,0,0,0,0,0,0,0,0,0,0,1,0,0,0,0,0,0,0,0,
0,0,0,0,0,0,0,0,0,0,0,0,1,0,0,0,0,0,0,0,0,
0,0,0,0,0,0,0,0,0,0,0,1,1,0,0,0,0,0,0,0,0,
0,0,0,0,0,0,0,0,0,0,0,1,0,0,0,0,0,0,0,0,0,
1,1,1,1,1,1,1,1,1,1,1,1,0,0,0,0,0,0,0,0,0,

layer 1
0,0,0,0,0,0,0,0,217,218,219,220,0,0,0,0,0,0,0,0,0,
0,0,0,0,165,166,167,0,233,234,235,236,0,0,0,0,0,0,0,0,0,
0,0,0,0,178,179,180,0,0,0,0,0,0,0,0,0,0,0,0,0,0,
0,0,0,160,194,195,196,0,0,0,0,0,0,0,0,0,0,0,0,0,0,
0,0,0,0,0,0,0,0,0,0,0,0,0,0,0,0,0,0,0,0,0,
0,0,0,0,0,63,0,0,0,0,0,0,0,0,0,0,0,0,0,0,0,
0,0,0,0,0,0,0,0,0,0,0,0,0,0,0,0,0,0,0,0,0,
0,0,0,0,0,0,0,0,0,0,0,0,0,0,0,0,0,0,0,0,0,
0,0,0,161,0,0,0,0,0,0,0,0,0,0,0,0,0,0,0,0,0,
0,0,0,0,0,0,0,0,0,0,0,0,0,0,0,170,0,0,0,0,0,
0,0,0,0,0,0,0,0,0,0,0,0,0,0,0,0,0,0,0,0,0,
0,0,0,0,0,0,0,0,0,0,0,0,0,0,0,0,0,0,0,0,0,
0,0,12,13,14,15,0,0,0,136,137,0,0,0,0,0,0,0,0,0,0,
0,0,28,29,30,31,126,0,138,149,150,0,0,0,0,0,0,0,0,0,0,
0,0,44,45,46,47,152,0,0,0,0,0,0,0,0,0,0,0,0,0,0,
0,0,0,0,0,0,0,0,0,0,0,0,0,0,0,0,0,0,0,0,0,
0,0,0,0,0,0,0,0,0,0,0,0,0,0,0,0,0,0,0,0,0,
0,0,0,183,184,0,0,0,0,0,0,0,0,0,0,0,0,0,0,0,0,
0,0,0,199,200,0,0,0,0,0,0,0,0,0,0,0,0,0,0,0,0,
0,0,208,231,232,208,0,0,0,0,0,0,0,0,0,0,0,0,0,0,0,
0,0,0,0,0,0,0,0,0,0,0,0,0,0,0,0,0,0,0,0,0,
0,0,0,0,0,0,0,0,0,0,0,0,0,0,0,0,0,0,0,0,0,
0,0,0,0,0,0,0,0,0,0,0,0,0,0,0,0,0,0,0,0,0,
0,0,0,0,0,0,0,0,0,0,0,0,0,0,0,0,0,0,0,0,0,
0,0,0,0,0,0,0,0,0,0,0,0,0,0,0,0,0,0,0,0,0,
0,0,0,0,0,0,0,0,0,0,0,0,0,0,0,0,0,0,0,0,0,


